{

  "doors" : [

    { "x":252, "y":16, "width":16, "height":16,
      "destination_zone":"03", "destination_x":0, "destination_y":-1 }
  ],

  "columns":16,
  "rows"   :9,

  "graphical_map": [32,33,33,33,33,33,33,33,33,33,33,33,33,33,33,34,
                    64,68,68,68,68,68,68,68,68,68,68,68,68,68,68,64,
                    64,68,68,68,68,68,68,68,68,68,68,68,68,68,68,64,
                    64,68,68,68,68,68,68,68,68,68,68,68,68,68,68,64,
                    64,68,68,68,68,68,68,68,68,68,68,68,68,68,68,64,
                    64,68,68,68,68,68,68,68,68,68,68,68,68,68,68,64,
                    64,68,68,68,68,68,68,68,68,68,68,68,68,68,68,64,
                    64,68,68,68,68,68,68,68,68,68,68,68,68,68,68,64,
                    96,97,97,97,97,97,97,97,97,97,97,97,97,97,97,98],


  "collision_map": [15,15,15,15,15,15,15,15,15,15,15,15,15,15,15,15,
                    11,0,0,0,0,0,0,0,0,0,0,0,0,0,0,11,
                    11,0,0,0,0,0,0,0,0,0,0,0,0,0,0,11,
                    11,0,0,0,0,0,0,0,0,0,0,0,0,0,0,11,
                    11,0,0,0,0,0,0,0,0,0,0,0,0,0,0,11,
                    11,0,0,0,0,0,0,0,0,0,0,0,0,0,0,11,
                    14,0,0,0,0,0,0,0,0,0,0,0,0,0,0,11,
                    11,0,0,0,0,0,0,0,0,0,0,0,0,0,0,11,
                    15,15,15,15,15,15,15,15,15,15,15,15,15,15,15,15],

  "id":""

}
