{

  "doors" : [

    { "x":252, "y":110, "width":16, "height":16,
      "destination_zone":"06", "destination_x":0, "destination_y":-1 }
  ],

  "columns":16,
  "rows"   :9,

  "graphical_map": [32,33,33,33,33,33,33,33,33,33,33,33,33,33,33,34,
                    64,138,68,68,68,68,68,35,68,68,68,68,68,68,73,64,
                    64,138,136,36,67,68,68,35,137,36,67,36,36,36,68,64,
                    64,138,68,68,37,69,68,35,68,68,37,138,68,68,68,64,
                    64,130,68,137,37,37,68,35,68,137,37,138,68,36,65,64,
                    64,162,68,68,37,68,40,68,68,68,37,138,68,68,68,64,
                    64,65,68,68,37,68,68,35,68,68,37,138,68,68,68,96,
                    64,65,132,132,37,132,132,35,132,132,37,65,69,68,68,68,
                    96,97,97,97,97,97,97,97,97,97,97,97,97,97,97,34],


  "collision_map": [15,15,15,15,15,15,15,15,15,15,15,15,15,15,15,15,
                    11,16,0,0,0,0,0,10,0,0,0,0,0,0,0,11,
                    11,16,1,15,15,0,0,10,1,15,11,11,15,15,0,11,
                    11,16,0,0,10,16,0,10,0,0,10,16,0,0,0,11,
                    11,0,0,1,10,11,0,15,0,1,10,16,0,15,15,11,
                    11,0,0,0,10,0,0,0,0,0,10,16,0,0,0,11,
                    14,11,0,0,10,0,0,11,0,0,10,16,0,0,0,15,
                    11,11,16,16,10,16,16,10,16,16,10,0,16,0,0,0,
                    15,15,15,15,15,15,15,15,15,15,15,15,15,15,15,15],

  "id":"05"

}
