{

  "doors" : [

    { "x":252, "y":50, "width":16, "height":16,
      "destination_zone":"13", "destination_x":0, "destination_y":-1 },

      { "x":0, "y":110, "width":16, "height":16,
        "destination_zone":"11", "destination_x":252, "destination_y":-1 }
  ],

  "columns":16,
  "rows"   :9,

  "graphical_map": [32,33,33,33,33,33,33,33,33,33,33,33,33,33,33,34,
                    64,74,38,38,38,68,128,68,68,68,68,68,68,68,73,64,
                    98,68,68,68,68,68,36,68,68,37,68,68,35,68,106,96,
                    68,68,36,69,36,132,132,132,132,37,132,132,35,68,68,68,
                    67,65,65,65,65,65,65,65,65,65,65,65,65,65,65,67,
                    64,74,68,68,68,70,68,68,70,68,68,68,68,68,73,64,
                    98,68,68,68,68,68,68,68,68,68,68,35,68,68,68,96,
                    68,68,36,132,132,36,69,69,36,132,132,35,69,68,68,68,
                    97,97,97,97,97,97,97,97,97,97,97,97,97,97,97,97],


  "collision_map": [15,15,15,15,15,15,15,15,15,15,15,15,15,15,15,15,
                    11,16,14,14,14,0,0,0,0,0,0,0,0,0,0,11,
                    14,0,0,0,0,0,11,0,0,11,0,0,11,0,16,14,
                    0,0,11,16,11,16,16,16,16,11,16,16,11,0,0,0,
                    15,5,5,5,5,5,5,5,5,5,5,5,5,5,5,15,
                    11,16,0,0,0,0,0,0,0,0,0,0,0,0,0,11,
                    14,0,0,0,0,0,0,0,0,0,0,11,0,0,0,14,
                    0,0,11,16,16,11,16,16,11,16,16,11,16,0,0,0,
                    15,15,15,15,15,15,15,15,15,15,15,15,15,15,15,15],

  "id":"12"

}
