{

  "doors" : [

  ],

  "columns":16,
  "rows"   :9,

  "graphical_map": [33,33,33,33,33,33,33,33,33,33,33,33,33,33,33,34,
                    68,68,35,74,68,35,68,68,70,68,68,68,68,68,73,64,
                    34,68,35,136,136,68,68,35,68,68,136,68,40,68,68,64,
                    64,68,35,136,136,67,36,67,69,69,68,68,68,68,68,64,
                    64,68,160,136,136,35,68,35,36,36,36,68,67,68,106,64,
                    64,68,128,136,136,35,138,68,68,68,68,68,35,68,106,64,
                    64,68,160,136,136,35,130,106,67,36,36,36,67,68,106,64,
                    64,69,128,136,136,35,162,68,68,68,68,68,68,68,68,64,
                    96,97,97,97,97,97,97,97,97,97,97,97,97,97,97,98],


  "collision_map": [15,15,15,15,15,15,15,15,15,15,15,15,15,15,15,15,
                    0,0,11,16,0,15,0,0,0,0,0,0,0,0,0,11,
                    11,0,11,1,1,0,0,15,0,0,1,0,0,0,0,11,
                    11,0,11,1,1,11,15,15,16,16,0,0,0,0,0,11,
                    11,0,0,1,1,11,0,15,15,15,15,0,11,0,16,11,
                    11,0,0,1,1,11,16,15,0,0,0,0,11,0,16,11,
                    14,0,0,1,1,11,17,16,15,15,15,15,15,0,16,11,
                    11,16,0,1,1,11,17,0,0,0,0,0,0,0,0,11,
                    15,15,15,15,15,15,15,15,15,15,15,15,15,15,15,15],

  "id":"04"

}
