{

  "doors" : [

    { "x":252, "y":16, "width":16, "height":16,
      "destination_zone":"07", "destination_x":0, "destination_y":-1 }
  ],

  "columns":16,
  "rows"   :9,

  "graphical_map": [32,33,33,33,33,33,33,33,33,33,33,33,33,33,33,33,
                    64,74,74,68,68,68,68,68,68,68,106,35,138,68,68,68,
                    64,68,68,68,35,68,136,68,37,68,106,35,138,68,33,34,
                    64,68,68,68,35,132,132,132,37,68,106,35,138,42,73,64,
                    64,68,136,68,35,36,36,36,37,68,68,35,68,68,136,64,
                    64,68,68,68,35,71,40,68,37,68,68,35,68,68,68,64,
                    98,136,68,68,35,68,131,68,37,138,68,68,68,136,68,64,
                    68,68,69,69,35,68,163,68,37,138,68,35,132,132,132,64,
                    97,97,97,97,97,97,97,97,97,97,97,97,97,97,97,98],


  "collision_map": [15,15,15,15,15,15,15,15,15,15,15,15,15,15,15,15,
                    11,16,16,0,0,0,0,0,0,0,16,11,16,0,0,0,
                    11,0,0,0,15,0,1,0,15,0,16,11,16,0,15,15,
                    11,0,0,0,11,16,16,16,11,0,16,11,16,0,0,11,
                    11,0,1,0,11,15,15,15,11,0,0,11,0,0,1,11,
                    11,0,0,0,11,0,0,0,11,0,0,11,0,0,0,11,
                    14,1,0,0,11,0,0,0,11,16,0,0,0,1,0,11,
                    0,0,16,16,11,0,0,0,11,16,0,11,16,16,16,11,
                    15,15,15,15,15,15,15,15,15,15,15,15,15,15,15,15],

  "id":"06"

}
