{

  "doors" : [

    { "x":252, "y":16, "width":16, "height":16,
      "destination_zone":"04", "destination_x":0, "destination_y":-1 }
  ],

  "columns":16,
  "rows"   :9,

  "graphical_map": [32,33,33,33,33,33,33,33,33,33,33,33,33,33,33,33,
                    98,71,68,67,68,70,68,68,68,68,68,106,35,74,68,68,
                    68,68,68,74,68,68,68,67,67,67,68,106,35,68,136,32,
                    34,68,68,68,136,68,68,68,35,138,68,106,35,68,68,64,
                    64,68,68,68,68,42,68,68,35,138,41,68,35,67,42,64,
                    64,68,68,68,68,68,136,68,35,138,68,68,35,68,68,64,
                    64,68,68,68,68,68,68,68,35,138,68,68,35,136,68,64,
                    64,132,132,67,69,69,69,69,35,138,69,68,68,68,69,64,
                    96,97,97,97,97,97,97,97,97,97,97,97,97,97,97,98],


  "collision_map": [15,15,15,15,15,15,15,15,15,15,15,15,15,15,15,15,
                    11,0,0,0,0,0,0,0,0,0,0,0,0,16,11,0,
                    0,0,0,16,0,0,0,15,15,15,0,0,11,0,1,11,
                    11,0,0,0,1,0,0,0,11,16,0,0,11,0,0,11,
                    11,0,0,0,0,0,0,0,11,16,0,0,11,15,0,11,
                    11,0,0,0,0,0,1,0,11,16,0,0,11,0,0,11,
                    14,0,0,0,0,0,0,0,11,16,0,0,15,1,0,11,
                    11,16,16,15,16,16,16,16,11,16,16,0,0,0,16,11,
                    15,15,15,15,15,15,15,15,15,15,15,15,15,15,15,15],

  "id":"03"

}
