{

  "doors" : [

    { "x":252, "y":36, "width":16, "height":16,
      "destination_zone":"03", "destination_x":0, "destination_y":-1 }
  ],

  "columns":16,
  "rows"   :9,

  "graphical_map": [32,33,33,33,33,33,33,33,33,33,33,33,33,33,33,34,
                    64,71,68,68,128,68,68,70,68,68,128,70,128,68,68,96,
                    64,68,68,68,160,68,68,68,68,68,160,68,160,68,68,68,
                    64,69,68,68,67,69,68,68,68,40,128,68,128,68,68,32,
                    64,67,67,68,68,67,36,36,68,68,160,69,160,68,68,64,
                    64,68,128,68,136,35,68,68,68,68,36,36,36,68,68,64,
                    98,68,65,68,68,35,68,68,68,68,68,68,68,68,68,64,
                    68,68,65,69,69,35,132,132,132,132,132,132,132,132,132,64,
                    97,97,97,97,97,97,97,97,97,97,97,97,97,97,97,98],


  "collision_map": [15,15,15,15,15,15,15,15,15,15,15,15,15,15,15,15,
                    11,0,0,0,0,0,0,0,0,0,0,0,0,0,0,15,
                    11,0,0,0,0,0,0,0,0,0,0,0,0,0,0,0,
                    11,16,0,0,15,16,0,0,0,0,0,0,0,0,0,11,
                    11,15,15,0,0,11,15,15,0,0,0,16,0,0,0,11,
                    11,0,0,0,1,11,0,0,0,0,15,15,15,0,0,11,
                    14,0,11,0,0,11,0,0,0,0,0,0,0,0,0,11,
                    0,0,11,16,16,11,16,16,16,16,16,16,16,16,16,11,
                    15,15,15,15,15,15,15,15,15,15,15,15,15,15,15,15],

  "id":"02"

}
