{

  "doors" : [

    { "x":252, "y":110, "width":16, "height":16,
      "destination_zone":"08", "destination_x":0, "destination_y":-1 }
  ],

  "columns":16,
  "rows"   :9,

  "graphical_map": [33,33,33,33,33,33,33,33,33,33,33,33,33,33,33,34,
                    68,68,68,67,71,68,68,68,68,160,68,68,128,68,73,64,
                    34,68,68,74,68,68,68,68,68,128,68,68,160,68,68,64,
                    64,68,68,68,68,68,69,68,68,70,68,68,128,69,68,64,
                    64,68,68,68,137,68,35,68,68,68,68,68,67,37,41,64,
                    64,68,68,68,68,68,35,68,68,68,68,68,68,37,68,64,
                    64,68,136,68,68,68,35,68,136,68,68,137,68,37,68,96,
                    64,132,132,132,132,132,35,132,132,132,132,132,132,37,68,68,
                    96,97,97,97,97,97,97,97,97,97,97,97,97,97,97,97],


  "collision_map": [15,15,15,15,15,15,15,15,15,15,15,15,15,15,15,15,
                    0,0,0,10,0,0,0,0,0,0,0,0,0,0,0,11,
                    11,0,0,16,0,0,0,0,0,0,0,0,0,0,0,11,
                    11,0,0,0,0,0,16,0,0,0,0,0,0,0,0,11,
                    11,0,0,0,1,0,10,0,0,0,0,0,15,16,0,11,
                    11,0,0,0,0,0,10,0,0,0,0,0,0,10,0,11,
                    14,0,1,0,0,0,10,0,1,0,0,1,0,10,0,11,
                    11,16,16,16,16,16,10,16,16,16,16,16,16,10,0,0,
                    15,15,15,15,15,15,15,15,15,15,15,15,15,15,15,15],

  "id":"07"

}
