{

  "doors" : [

    { "x":252, "y":32, "width":16, "height":16,
      "destination_zone":"01", "destination_x":0, "destination_y":-1 }

  ],

  "columns":16,
  "rows"   :9,

  "graphical_map": [32,33,33,33,33,33,33,33,33,33,33,33,33,33,33,34,
                    64,68,68,68,68,68,70,68,68,37,68,70,68,68,73,96,
                    64,68,68,137,68,68,68,68,68,37,68,68,68,68,68,68,
                    64,68,68,68,68,68,35,68,68,37,68,68,68,136,68,32,
                    64,136,68,68,68,68,35,68,68,67,36,36,68,68,68,66,
                    64,68,68,68,68,68,35,68,68,68,68,68,68,68,68,66,
                    64,130,68,137,131,68,35,68,68,37,68,68,68,67,68,66,
                    64,162,68,68,163,68,35,132,132,37,68,68,67,67,69,66,
                    96,97,97,97,97,97,97,97,97,97,97,97,97,97,97,98],


  "collision_map": [15,15,15,15,15,15,15,15,15,15,15,15,15,15,15,15,
                    10,0,0,0,0,0,0,0,0,10,0,0,0,0,0,15,
                    10,0,0,1,0,0,0,0,0,10,0,0,0,0,0,0,
                    10,0,0,0,0,0,11,0,0,10,0,0,0,1,0,11,
                    10,1,0,0,0,0,10,0,0,15,15,15,0,0,0,10,
                    10,0,0,0,0,0,10,0,0,0,0,0,0,0,0,10,
                    10,0,0,1,0,0,10,0,0,11,0,0,0,11,0,10,
                    10,0,0,0,0,0,10,16,16,10,0,0,15,10,16,10,
                    15,15,15,15,15,15,15,15,15,15,15,15,15,15,15,15],

  "id":"00"

}
