{

  "doors" : [

    { "x":252, "y":110, "width":16, "height":16,
      "destination_zone":"09", "destination_x":0, "destination_y":-1 }
  ],

  "columns":16,
  "rows"   :9,

  "graphical_map": [32,33,33,33,33,33,33,33,33,33,33,33,33,33,33,34,
                    64,68,68,68,68,68,68,70,68,70,68,70,68,68,73,64,
                    64,68,137,35,68,37,68,68,68,68,68,68,68,68,68,64,
                    64,68,68,35,138,37,132,136,132,137,132,136,132,36,68,64,
                    64,137,68,35,106,37,36,36,36,36,36,36,36,36,68,64,
                    64,68,68,35,138,37,71,68,128,68,128,68,128,68,68,64,
                    98,68,136,35,106,37,138,68,36,68,36,68,36,68,36,96,
                    68,68,68,35,132,37,138,68,68,68,68,68,68,68,40,68,
                    97,97,97,97,97,97,97,97,97,97,97,97,97,97,97,97],


  "collision_map": [15,15,15,15,15,15,15,15,15,15,15,15,15,15,15,15,
                    11,0,0,0,0,0,0,0,0,0,0,0,0,0,0,11,
                    11,0,1,15,0,15,0,0,0,0,0,0,0,0,0,11,
                    11,0,0,10,16,10,16,1,16,1,16,1,16,15,0,11,
                    11,1,0,10,16,10,14,14,14,14,14,14,14,14,0,11,
                    11,0,0,10,16,10,0,0,0,0,0,0,0,0,0,11,
                    14,0,1,10,16,10,16,0,15,0,15,0,15,0,15,11,
                    0,0,0,10,16,10,16,0,0,1,0,1,0,1,0,0,
                    15,15,15,15,15,15,15,15,15,15,15,15,15,15,15,15],

  "id":"08"

}
