{

  "doors" : [

    { "x":0, "y":110, "width":16, "height":16,
      "destination_zone":"13", "destination_x":252, "destination_y":-1 }
  ],

  "columns":16,
  "rows"   :9,

  "graphical_map": [32,33,33,33,33,33,33,33,33,33,33,33,33,33,33,34,
                    64,138,68,68,38,38,38,68,160,68,70,68,160,68,68,64,
                    98,138,137,136,68,68,68,68,128,68,68,68,128,68,68,64,
                    68,68,137,137,36,69,36,68,36,132,36,132,36,68,68,64,
                    67,65,65,65,65,65,65,68,65,65,65,65,65,68,68,64,
                    64,68,68,68,68,68,68,68,106,38,68,68,68,68,68,64,
                    98,68,68,136,68,137,68,136,68,68,68,68,68,68,68,64,
                    68,68,68,68,68,68,68,68,68,68,68,69,68,69,69,64,
                    97,97,97,97,97,97,97,97,97,97,97,97,97,97,97,98],


  "collision_map": [15,15,15,15,15,15,15,15,15,15,15,15,15,15,15,15,
                    11,16,0,0,14,14,14,0,0,0,0,0,0,0,0,11,
                    14,16,1,1,0,0,0,0,0,0,0,0,0,0,0,11,
                    0,0,1,1,11,16,11,0,11,16,11,16,11,0,0,11,
                    15,5,5,5,5,5,15,0,15,5,5,5,15,0,0,11,
                    11,0,0,0,0,0,0,0,16,14,0,0,0,0,0,11,
                    14,0,0,11,0,11,0,11,8,0,0,0,0,0,0,11,
                    0,5,5,5,5,5,5,5,0,0,0,16,0,16,16,11,
                    15,15,15,15,15,15,15,15,15,15,15,15,15,15,15,15],

  "id":"14"

}
