{

  "doors" : [


    { "x":252, "y":110, "width":16, "height":16,
      "destination_zone":"02", "destination_x":0, "destination_y":-1 }
  ],

  "columns":16,
  "rows"   :9,

  "graphical_map": [32,33,33,33,33,33,33,33,33,33,33,33,33,33,33,34,
                    98,68,160,68,160,68,67,68,160,68,68,160,68,68,73,66,
                    68,68,128,68,128,68,67,68,128,68,68,128,68,41,68,66,
                    34,68,136,68,160,68,128,68,137,68,68,136,68,68,68,66,
                    64,68,68,68,128,68,136,68,68,68,68,68,69,68,69,66,
                    64,68,68,68,137,68,68,68,68,68,68,68,35,68,35,66,
                    64,68,68,68,68,68,68,68,68,68,68,68,35,68,101,96,
                    64,132,132,132,132,132,132,132,132,132,132,132,35,68,68,68,
                    96,97,97,97,97,97,97,97,97,97,97,97,97,97,97,97],


  "collision_map": [15,15,15,15,15,15,15,15,15,15,15,15,15,15,15,10,
                    15,0,0,0,0,0,15,0,0,0,0,0,0,0,0,10,
                    0,0,0,0,0,0,15,0,0,0,0,0,0,0,0,10,
                    11,0,1,0,0,0,0,0,1,0,0,1,0,0,0,10,
                    10,0,0,0,0,0,1,0,0,0,0,0,16,0,16,10,
                    10,0,0,0,1,0,0,0,0,0,0,0,11,0,11,10,
                    10,0,0,0,0,0,0,0,0,0,0,0,10,0,15,15,
                    10,16,16,16,16,16,16,16,16,16,16,16,10,0,0,0,
                    15,15,15,15,15,15,15,15,15,15,15,15,15,15,15,15],

  "id":"01"

}
