{

  "doors" : [

    { "x":252, "y":50, "width":16, "height":16,
      "destination_zone":"11", "destination_x":0, "destination_y":-1 }
  ],

  "columns":16,
  "rows"   :9,

  "graphical_map": [32,33,33,33,33,33,33,33,33,33,33,33,33,33,33,34,
                    64,130,68,68,68,68,68,68,68,68,68,68,68,68,73,64,
                    64,162,68,131,68,68,68,68,68,68,68,68,68,68,68,96,
                    64,68,68,163,68,69,68,69,68,69,68,69,68,69,68,68,
                    64,65,65,65,65,65,65,65,65,65,65,65,65,65,65,67,
                    64,130,74,68,68,68,68,68,128,68,128,68,68,70,68,64,
                    64,162,68,68,131,68,68,68,36,68,36,68,68,68,68,96,
                    64,36,68,68,163,68,36,132,132,132,132,132,36,68,68,68,
                    96,97,97,97,97,97,97,97,97,97,97,97,97,97,97,97],


  "collision_map": [15,15,15,15,15,15,15,15,15,15,15,15,15,15,15,15,
                    11,0,0,0,0,0,0,0,0,0,0,0,0,0,0,11,
                    11,0,0,0,0,0,0,0,0,0,0,0,0,0,0,14,
                    11,0,0,0,0,16,0,16,0,16,0,16,0,16,0,0,
                    11,5,5,5,5,5,5,5,5,5,5,5,5,5,5,11,
                    11,17,16,0,0,0,0,0,0,0,0,0,0,0,0,11,
                    14,17,0,0,0,0,0,0,15,0,15,0,0,0,0,14,
                    11,11,0,0,0,0,11,16,16,16,16,16,11,0,0,0,
                    15,15,15,15,15,15,15,15,15,15,15,15,15,15,15,15],

  "id":"10"

}
