{

  "doors" : [

  ],

  "columns":16,
  "rows"   :9,

  "graphical_map": [32,33,33,33,33,33,33,33,33,33,33,33,33,33,33,34,
                    64,68,68,68,68,68,68,68,70,37,130,68,68,68,73,64,
                    64,136,36,36,36,36,36,67,68,37,162,68,137,68,68,64,
                    64,68,68,68,68,68,73,35,68,37,36,68,68,68,68,64,
                    64,36,69,36,68,68,68,68,41,37,68,68,68,68,136,64,
                    64,38,38,38,38,68,68,35,68,37,68,68,68,68,68,64,
                    98,68,68,68,68,68,68,35,68,37,68,68,137,68,68,64,
                    68,68,36,69,36,132,132,35,68,68,68,69,36,132,132,64,
                    97,97,97,97,97,97,97,97,97,97,97,97,97,97,97,98],


  "collision_map": [15,15,15,15,15,15,15,15,15,15,15,15,15,15,15,15,
                    11,0,0,0,0,0,0,0,0,10,17,0,0,0,0,11,
                    11,1,15,15,15,15,15,11,0,10,17,0,1,0,0,11,
                    11,0,0,0,0,0,0,14,0,10,15,0,0,0,0,11,
                    11,15,16,15,0,0,0,0,10,10,0,0,0,0,1,11,
                    11,15,15,15,15,0,0,15,0,10,0,0,0,0,0,11,
                    14,0,0,0,0,0,0,10,0,14,0,0,1,0,0,11,
                    0,0,15,16,15,16,16,10,0,0,0,16,15,16,16,11,
                    15,15,15,15,15,15,15,15,15,15,15,15,15,15,15,15],

  "id":"09"

}
